20
3
XXXXXXXXXX
X<     XXX
X X      X
X        X
X      X X
X XX     X
X    X X X
XX   XX  X
XX   X XTX
XXXXXXXXXX